1111111111111111111
1000000000000000011
1010100100001000011
101110000001C1E0011
1010100100000000011
1000000100000111111
1001100000000111111
1010000000000111111
10100CCCCC000111111
10100CCCCC000000011
1010000000000000011
1010000110000000011
1010000000000000011
11P0011100000000011
1010000010000000011
1010000000000000011
1110111111111111111
1111111111111111111
