1111111111111111111
1000000000000000011
1010100100001000011
101110000001C100011
1010100100000000011
1000000100000111111
1001100000000111111
1010000000000111111
10100CCCCC000111111
10100CCCCC000000011
1010000000000000011
1010000110000000011
1000000000000000011
10P0011110000000011
1000000010000000011
1010000000000000011
11E0111111111111111
1111111111111111111
