111111111111111111
100000000000000001
101010010000100001
101110000001C10001
101010010000000001
100000010000000001
100110000000001101
101000000000001101
10100CCCCC00001101
10100CCCCC00000001
101000000000000001
101000011000000001
100000000000000001
10P001111000000001
100000001000000001
100000000000000001
10EC11111111111111
111111111111111111
