1111111111
10000000E1
1000000001
100000C001
10000C0001
1000C00001
100C000001
10C0000001
1P00000001
1111111111