11111111111111111111111111111
10000000000000000000000000001
10000000000CCCCC00000E0000001
10000000000CCCCC0000000000001
10000000000CCCCC0000000000001
10000000000CCCCC0000000000001
10000000000000000000000000001
1000000000000P000000000000001
10000000000000000000000000001
11111111111111111111111111111
