11111111111111111111111111111
1000000000000C1100000000011E1
100000C1111C01111111C001001C1
1000001000000C00000C100010001
100000101111C011111C010011111
100000100000C010000C010000011
1000111C0000C010000C011111011
10001000C000C0100000C00010001
100010001111111111C0000110011
100010000000000000C0000111001
10001111111111111111111110001
100000000000P0000000000000001
11111111111111111111111111111
